NO  /mnt/homes/yhajji/Desktop/Cub3D/texters/wall.xpm
SO  /mnt/homes/yhajji/Desktop/Cub3D/texters/wall.xpm
F   0,0,10
WE  /mnt/homes/yhajji/Desktop/Cub3D/texters/wall.xpm
EA  /mnt/homes/yhajji/Desktop/Cub3D/texters/wall.xpm
C   225,30,0

        11111111111111111111111111
        100000000011000000000000001
        101100000111000000000000111
        1001000000000000000000001
111111111011000001110000000000001
100000000011000001110111111111111



11110111111111011100000010001
11110111111111S11101010010001
11000000110101011100000010001
10000000000000101100000010001
10000000000100001101010010001
10000000000000001101010010001
11000001110101011111011110001
11000001010101011111011110001
11000001010101011111011110001
111101111111111 101111010011
111111111       111111111111
