NO  ../texters/wall.xpm
SO  ../texters/wall.xpm
WE  ../texters/wall.xpm
EA  ../texters/wall.xpm
F   0,0,10
C   173,216,230

1111
1E00
1111