NO  ../../texters/wall.xpm
SO  ../../texters/wall.xpm
WE  ../../texters/wall.xpm
EA  ../../texters/wall.xpm
F   0,0,10
C   173,216,230

        111111111111111111111111111111111111111111
        100000000011000000000000000000000000000001
        101100000111000111000010000010010000100001
        100100000000000001000010000011110000100001
11111111101100000111000111000000000000000000000001
10000000001100000111000000001111111111111111111111
11110111111111011100000010001
11110111111111011101010000001
11000000110101011100000010001
10000W00000000001100000010001
10000000000000001101010010001
11000001110101011111011110001
11110111 1110101 101111010001
11111111 1111111 111111111111