NO  ../../texters/wall.xpm
SO  ../../texters/wall.xpm
WE  ../../texters/wall.xpm
EA  ../../texters/wall.xpm
F   0,0,10
C   173,216,230

11111111111111111111111111
100000000000001
101100000000111
100100000000111111111
111111111000000000001
100000000011111111111
11110111100010001
11110111110010001
11000000100010001
10000000000010001
100000S0010010001
10000000010010001
11000001111110001
11000001011110001
11000001011110001
1111011111010011
11111111111111111111