NO  texters/wall.xpm
SO  texters/wall.xpm                            
WE  texters/wall.xpm                     
EA  texters/wall.xpm

F   0,0,10              
C   173,216,001 

11111111111111111111111111111111111111111
10000000000000E0000000000000000001111111111111111111111111111111111111
1111111111111100000001111111111111111111
11111111111111111111111111111111111111111111111111111111111111111