NO  ../cub/texters/wall.xpm
SO  ../cub/texters/wall.xpm
WE  ../cub/texters/wall.xpm
EA  ../cub/texters/wall.xpm
F   0,0,255
C     0,5,0


11111111111111111111111111111111
1N0000000000000000000000000000001
111111111111111111111111111111111